[map]
layout= wwwwwwwwwwwwwwwwwwww
	wp.e..e...w....e...w
	w....h....w.h....e.w
	w.h...e...w.e...h..w
	we.e...e.......e...w
	wwwwwwwwwwwwww..wwww
	wwwwwwwwwww.e......w
	w.h.e....h.....e...w
	w....h...e..e......w
	wwwwwwwwwwwwwwwwww.w
	w..e..e...e...e....w
	w....e.....e....e..w
	wwwwwwwwwwwwwwwfwwww